Eメールアドレス	xsd:string	電子メールアドレスを記述するためのプロパティ用語
FAX番号	ic2:電話番号型	FAX番号を記述するためのプロパティ用語　※0-9 の数字及び + - ( ) , の文字のみを使用
ID	ic2:ID型	事物に割り振られたID（識別子)を記述するためのプロパティ用語
Webサイト		Webサイトを参照するURLを記述するためのプロパティ用語
アクセス	ic2:アクセス型	アクセス方法を記述するためのプロパティ用語
アクセス区間	ic2:アクセス区間型	アクセス方法の各区間の一覧を記述するためのプロパティ用語
カナ表記	xsd:string	カタカナ表記を記述するためのプロパティ用語
カレンダー	ic2:コード型	カレンダーの種類を表すコードを記述するためのプロパティ用語
キーワード	xsd:string	キーワードの記述のためのプロパティ用語
コード種別	ic2:コードリスト型	コードの種別を記述するためのプロパティ用語
サイズ	xsd:string	サイズの表記を記述するためのプロパティ用語
シリアル番号	ic2:ID型	シリアル番号を記述するためのプロパティ用語
バリアフリー	xsd:string	設備などのバリアフリーに関する情報の記述のためのプロパティ用語
バージョン	xsd:string	バージョン情報を記述するためのプロパティ用語
ビル名	xsd:string	ビル名を記述するためのプロパティ用語
ビル番号	xsd:string	ビルの番号の表記（号棟など）を記述するためのプロパティ用語
ミドルネーム	xsd:string	ミドルネームの表記を記述するためのプロパティ用語
ミドルネームカナ表記	xsd:string	ミドルネームのカタカナ表記を記述するためのプロパティ用語
ミドルネームローマ字表記	xsd:string	ミドルネームのローマ字表記を記述するためのプロパティ用語
メタデータ	ic2:文書型	データのメタデータを記述するためのプロパティ用語
ロット番号	xsd:string	製造ロットの番号を記述するためのプロパティ用語
ローマ字表記	xsd:string	ローマ字表記を記述するためのプロパティ用語
丁目	xsd:string	丁目の表記を記述するためのプロパティ用語
上位コード	ic2:コード型	当該コードの上位に位置するコードを記述するためのプロパティ用語
上限値	ic2:数量型	範囲制約の上限値を記述するためのプロパティ用語
下位コード	ic2:コード型	当該コードの下位に位置するコードを記述するためのプロパティ用語
下限値	ic2:数量型	範囲制約の下限値を記述するためのプロパティ用語
主要用途	xsd:string	建物などの主要用途の表記を記述するためのプロパティ用語
乗数	xsd:double	基本単位に対する変換乗数を記述するためのプロパティ用語
事業年度開始日	ic2:日付型	事業年度の開始日を記述するためのプロパティ用語
事業種目	xsd:string	事業の種類の表記（販売業など）を記述するためのプロパティ用語
人数	xsd:nonNegativeInteger	人数を記述するためのプロパティ用語
代理人	ic2:組織関連型	法定手続きなどの代理人となる組織を記述するためのプロパティ用語
代表者	ic2:構成員型	組織の代表者を記述するためのプロパティ用語
住所	ic2:住所型	住所を記述するためのプロパティ用語
住所コード	ic2:コード型	住所のコードを記述するためのプロパティ用語　※地方公共団体情報システム機構の地方公共団体コード住所など
体系	ic2:ID体系型	IDの体系を記述するためのプロパティ用語
体重	ic2:数量型	人の体重を記述するためのプロパティ用語
作成者	ic2:実体型	文書の内容の作成に主たる責任をもつ実体を記述するためのプロパティ用語
使用方法	xsd:string	使用方法の説明を記述するためのプロパティ用語
使用期限	ic2:日付型	使用期限を記述するためのプロパティ用語
価格	ic2:価格型	価格（製品の価格など）を記述するためのプロパティ用語
備考	xsd:string	備考を記述するためのプロパティ用語　※補足情報などがある場合に記述
入数	ic2:数量型	箱などに含まれる物の数量を記述するためのプロパティ用語
内線番号	xsd:string	電話の内線番号を記述するためのプロパティ用語
出処	xsd:string	当該文書の由来となるような関係の文書源を記述するためのプロパティ用語
出生国	xsd:string	生まれた国名を記述するためのプロパティ用語
出生国コード	ic2:コード型	生まれた国のコードを記述するためのプロパティ用語
出生地	ic2:住所型	生まれた場所を記述するためのプロパティ用語
分	xsd:integer	日時などの分の値を記述するためのプロパティ用語
利用可能時間	ic2:期間スケジュール型	利用可能日と利用可能時間を記述するためのプロパティ用語
利用対象	ic2:対象型	利用対象となる事物を記述するためのプロパティ用語
利用方法	xsd:string	利用方法を記述するためのプロパティ用語
利用者	xsd:string	利用者の条件を記述するためのプロパティ用語　※利用者に限定条件がある場合
制約	ic2:制約型	対象となる事物の制約を記述するためのプロパティ用語
制約コード	ic2:コード型	制約コードを記述するためのプロパティ用語
制約対象	xsd:string	制約対象を記述するためのプロパティ用語
区	xsd:string	政令指定都市の区の名前を記述するためのプロパティ用語
単位	ic2:単位コード型	計測値の単位を表すコードを記述するためのプロパティ用語
単位表記	xsd:string	単位の文字列による表現を記述するためのプロパティ用語
原産国	xsd:string	原産国名を記述するためのプロパティ用語
原産国コード	ic2:コード型	原産国を表すコードを記述するためのプロパティ用語
参加方法	xsd:string	イベントなどへの参加方法の説明を記述するためのプロパティ用語
参照	ic2:参照型	追加情報などを参照するURLを記述するためのプロパティ用語
参照先		追加情報などを参照するURLを記述するためのプロパティ用語
収容人数	ic2:数量型	収容人数を記述するためのプロパティ用語
収容台数	xsd:integer	駐車場の収容可能台数を記述するためのプロパティ用語
号	xsd:string	号、住居番号の表記を記述するためのプロパティ用語
名	xsd:string	氏名の名の表記を記述するためのプロパティ用語
名カナ表記	xsd:string	氏名の名のカタカナ表記を記述するためのプロパティ用語
名ローマ字表記	xsd:string	氏名の名のローマ字表記を記述するためのプロパティ用語
名称	ic2:名称型	名称を記述するためのプロパティ用語
国	xsd:string	国名を記述するためのプロパティ用語
国コード	ic2:コード型	国のコードを記述するためのプロパティ用語
国籍	xsd:string	国籍の表記を記述するためのプロパティ用語
国籍コード	ic2:コード型	国籍コードを記述するためのプロパティ用語　※住民基本台帳で利用されているものを使用
地上階数	xsd:decimal	建物の地上階数を記述するためのプロパティ用語
地下階数	xsd:decimal	建物の地下階数を記述するためのプロパティ用語
地図		地図を参照するURLを記述するためのプロパティ用語
地物	ic2:地物型	関連する地物（施設、建物、土地など）を記述するためのプロパティ用語
地理座標	ic2:座標型	場所の経緯度座標を記述するためのプロパティ用語
地理識別子	ic2:ID型	場所の地理識別子を記述するためのプロパティ用語
場所	ic2:場所型	場所を記述するためのプロパティ用語
境界を含まない上限値	ic2:数量型	範囲制約の境界を含まない上限値を記述するためのプロパティ用語
境界を含まない下限値	ic2:数量型	範囲制約の境界を含まない下限値を記述するためのプロパティ用語
外部利用可否	xsd:string	施設や設備などの外部利用可否の記述のためのプロパティ用語
始点	ic2:地物型	始点となる地物を記述するためのプロパティ用語
始点備考	xsd:string	始点についての備考を記述するためのプロパティ用語
姓	xsd:string	氏名の姓の表記を記述するためのプロパティ用語
姓カナ表記	xsd:string	氏名の姓のカタカナ表記を記述するためのプロパティ用語
姓ローマ字表記	xsd:string	氏名の姓のローマ字表記を記述するためのプロパティ用語
姓名	xsd:string	氏名（姓、名）の表記を記述するためのプロパティ用語
姓名カナ表記	xsd:string	氏名（姓、名）のカタカナ表記を記述するためのプロパティ用語
姓名ローマ字表記	xsd:string	氏名（姓、名）のローマ字表記を記述するためのプロパティ用語
寄与者	ic2:実体型	文書の内容になんらかの寄与、貢献をした実体を記述するためのプロパティ用語
対応言語	xsd:string	連絡の際に利用可能な言語名を記述するためのプロパティ用語
市区町村	xsd:string	市区町村名を記述するためのプロパティ用語
市区町村コード	ic2:コード型	市区町村のコードを記述するためのプロパティ用語
幅	ic2:長さ型	形状の幅を記述するためのプロパティ用語
年	xsd:integer	日付や日時などの年の値を記述するためのプロパティ用語
年号	xsd:string	日付や日時などの元号を記述するためのプロパティ用語
年齢	ic2:数量型	人の年齢を記述するためのプロパティ用語
座標データ	xsd:string	点、線、面などを表現するデータ文字列の書式を記述するためのプロパティ用語
座標データ書式	ic2:コード型	点、線、面などを表現するデータ文字列の書式を表すコードを記述するためのプロパティ用語
座標参照系	ic2:ID型	座標の参照系を記述するためのプロパティ用語
延べ面積	ic2:面積型	建物の延べ床面積を記述するためのプロパティ用語
建物	ic2:建物型	建物を記述するためのプロパティ用語
建築面積	ic2:面積型	建築面積を記述するためのプロパティ用語
形態	xsd:string	製品などの形態の説明を記述するためのプロパティ用語
役割	xsd:string	人、組織、施設などの役割の表記を記述するためのプロパティ用語
役割コード	ic2:コード型	人、組織、施設などの役割を表すコードを記述するためのプロパティ用語
性別	xsd:string	性別の表記を記述するためのプロパティ用語
性別コード	ic2:コード型	性別コードを記述するためのプロパティ用語
所有者	ic2:実体型	所有者を記述するためのプロパティ用語
担当者名	ic2:氏名型	担当者の氏名を記述するためのプロパティ用語
担当者役職	xsd:string	担当者の役職の表記を記述するためのプロパティ用語
提供者	ic2:実体型	サービス等を提供する組織や人を記述するためのプロパティ用語
携帯電話番号	ic2:電話番号型	携帯電話番号を記述するためのプロパティ用語　※0-9 の数字及び + - ( ) , の文字のみを使用
数値	xsd:decimal	数値を記述するためのプロパティ用語
敷地面積	ic2:面積型	敷地面積を記述するためのプロパティ用語
料金	ic2:価格型	料金（施設、設備の利用料金やイベントの参加費など）を記述するためのプロパティ用語
方書	xsd:string	方書 (私書箱も含む)を記述するためのプロパティ用語
施設	ic2:施設型	施設を記述するためのプロパティ用語
日	xsd:integer	日付や日時などの日の値を記述するためのプロパティ用語
日付	ic2:日付型	文書のライフサイクルにおけるなんらかの事象に関するある時点又は時間的区間を記述するためのプロパティ用語
日時	ic2:日時型	活動などが行われる日時を記述するためのプロパティ用語
時	xsd:integer	日時などの時の値を記述するためのプロパティ用語
時間	ic2:数量型	所要時間を記述するためのプロパティ用語
時間帯	xsd:string	時間帯を記述するためのプロパティ用語　※協定世界時からの時間差
最高の高さ	ic2:長さ型	最高点の高さを記述するためのプロパティ用語
月	xsd:integer	日付や日時などの月の値を記述するためのプロパティ用語
有効終了日時	ic2:日時型	スケジュールが無効になる日時を記述するためのプロパティ用語
有効開始日時	ic2:日時型	スケジュールが有効になる日時を記述するためのプロパティ用語
期間	ic2:期間スケジュール型	開始から終了までの時間範囲を記述するためのプロパティ用語
本籍	ic2:住所型	本籍を記述するためのプロパティ用語
概要	xsd:string	概要説明を記述するためのプロパティ用語
構成員	ic2:人型	構成員を記述するためのプロパティ用語
構造	xsd:string	建物などの構造の表記を記述するためのプロパティ用語
標準型日付	xsd:date	日付を記述するためのプロパティ用語　※XMLのxsd:date型に準拠したもの
標準型日時	xsd:dateTime	日時を記述するためのプロパティ用語　※XMLのxsd:dateTime型に準拠したもの
権利管理	ic2:文書型	文書に含まれる、又はかかわる権利管理に関する情報を記述するためのプロパティ用語
死亡年月日	ic2:日付型	死亡年月日を記述するためのプロパティ用語
氏名	ic2:氏名型	人の氏名を記述するためのプロパティ用語
活動	ic2:活動型	組織などの活動を記述するためのプロパティ用語
活動状況	ic2:状況型	組織などの活動状況を記述するためのプロパティ用語
消費期限	ic2:日付型	消費期限を記述するためのプロパティ用語
測地高度	ic2:長さ型	測地高度を記述するためのプロパティ用語
状態	xsd:string	状態を記述するためのプロパティ用語
生年月日	ic2:日付型	生年月日を記述するためのプロパティ用語
町名	xsd:string	町域、または市区町村の下の行政区分の表記を記述するためのプロパティ用語
画像		画像を参照するURLを記述するためのプロパティ用語
略称アルファベット	xsd:string	頭文字などを使った略称表記を記述するためのプロパティ用語
番地	xsd:string	番、街区の表記を記述するためのプロパティ用語
番地補足	xsd:string	番地の前の、「東」「北」「浜」「甲」「イ」などの文字を記述するためのプロパティ用語
発生日	ic2:日時型	状況などの発生日時を記述するためのプロパティ用語
発行者	ic2:実体型	IDやコードリストなどの発行主体を記述するためのプロパティ用語
秒	xsd:decimal	日時などの秒の値を記述するためのプロパティ用語
種別	xsd:string	様々な事物の種別の表記を記述するためのプロパティ用語
種別コード	ic2:コード型	種別コードを記述するためのプロパティ用語
竣工日	ic2:日付型	建物の竣工日を記述するためのプロパティ用語
管理者	ic2:実体型	管理している組織や人を記述するためのプロパティ用語
終了日	ic2:日付型	イベントなどの終了日を記述するためのプロパティ用語
終了日時	ic2:日時型	期間の終了日時を記述するためのプロパティ用語
終了時間	xsd:time	場所やサービスなどの終了時間を記述するためのプロパティ用語
終点	ic2:地物型	終点となる地物を記述するためのプロパティ用語
終点備考	xsd:string	終点についての備考を記述するためのプロパティ用語
組織	ic2:組織型	組織を記述するためのプロパティ用語
組織種別	ic2:コード型	組織の種別コード（株式会社など）を記述するためのプロパティ用語
組織種別位置	xsd:string	組織名称中の組織種別の記載位置の表記（前、後、など）を記述するためのプロパティ用語
経度	xsd:string	経度を記述するためのプロパティ用語　※-180から+180で記載
緯度	xsd:string	緯度を記述するためのプロパティ用語　※-90から+90で記載
緯度経度書式	xsd:string	度、分、秒の書式を記述するためのプロパティ用語　※書式はiso6709に準拠する
自動認識ID		自動認識ID（バーコードや二次元コードの画像など）が表すURLを記述するためのプロパティ用語
色	xsd:string	色の表記を記述するためのプロパティ用語
表記	xsd:string	文字列による表記を記述するためのプロパティ用語
表題	xsd:string	文書に与えられた名前を記述するためのプロパティ用語
製造日	ic2:日付型	製造日を記述するためのプロパティ用語
製造者	xsd:string	製造者名を記述するためのプロパティ用語
製造者ID	ic2:ID型	製造者によって割り当てられたIDを記述するためのプロパティ用語
要約	xsd:string	説明の要約を記述するためのプロパティ用語
規制情報	xsd:string	規制に関する情報（取り扱い上の注意など）を記述するためのプロパティ用語
言語	ic2:コード型	文書の言語を記述するためのプロパティ用語
記述	ic2:記述型	種別付きの説明文を記述するためのプロパティ用語
記録形式	xsd:string	文書のファイルの記録形式、物理媒体又は次元を記述するためのプロパティ用語
記録形式コード	ic2:コード型	文書のファイルの記録形式、物理媒体又は次元のコードを記述するためのプロパティ用語
設備	ic2:設備型	設備を記述するためのプロパティ用語
設立日	ic2:日付型	組織などの設立日を記述するためのプロパティ用語
設置位置	xsd:string	設備などの設置場所の表記（受付横など）を記述するためのプロパティ用語
設置地点	ic2:地物型	設備などが設置されている地物（施設や建物など）を記述するためのプロパティ用語
設置日	ic2:日付型	設備などの設置日を記述するためのプロパティ用語
設置者	ic2:組織型	設備などを設置した組織を記述するためのプロパティ用語
説明	xsd:string	説明を記述するためのプロパティ用語
識別値	xsd:string	IDやコードの値を記述するためのプロパティ用語
販売業者	xsd:string	販売業者名を記述するためのプロパティ用語
販売業者ID	ic2:ID型	販売業者によって割り当てられたIDを記述するためのプロパティ用語
資本金	ic2:金額型	法人などの資本金を記述するためのプロパティ用語
資源タイプ		文書の性質又はジャンルを記述するためのプロパティ用語
賞味期限	ic2:日付型	賞味期限を記述するためのプロパティ用語
購入価格	ic2:金額型	購入価格を記述するためのプロパティ用語
路線	xsd:string	アクセス区間に用いる交通の路線（事業者及び路線名、バス系統など）を記述するためのプロパティ用語
身長	ic2:数量型	人の身長を記述するためのプロパティ用語
送付先	xsd:string	郵便物送付先の住所（私書箱など）を記述するためのプロパティ用語
通称	xsd:string	正式な名称以外に一般的に使用されている名称を記述するためのプロパティ用語
通貨	xsd:string	通貨名を記述するためのプロパティ用語
通貨コード		通貨コードを記述するためのプロパティ用語
連絡先	ic2:連絡先型	連絡先を記述するためのプロパティ用語
部屋番号	xsd:string	部屋番号の表記（階数、号室など）を記述するためのプロパティ用語
郵便番号	xsd:string	郵便番号を記述するためのプロパティ用語　※0-9の数字7桁
都道府県	xsd:string	都道府県名を記述するためのプロパティ用語
都道府県コード	ic2:コード型	都道府県のコードを記述するためのプロパティ用語
重量	ic2:重量型	重量を記述するためのプロパティ用語
量種別	xsd:string	量の種別の表記を記述するためのプロパティ用語
金額	ic2:金額型	金額を記述するためのプロパティ用語
長さ	ic2:長さ型	形状の長さを記述するためのプロパティ用語
開催場所	ic2:地物型	イベントなどの開催場所を記述するためのプロパティ用語
開催日	ic2:日付型	イベントなどが開催される日付を記述するためのプロパティ用語
開催期日	xsd:string	スケジュールが有効となる日を記述するためのプロパティ用語　※スケジュールの種別が「週間」の場合は曜日、「月間」の場合は月の中の日、「年間」の場合は年の中の月日を指定する。
開始日	ic2:日付型	イベントなどの開始日を記述するためのプロパティ用語
開始日時	ic2:日時型	期間の開始日時を記述するためのプロパティ用語
開始時間	xsd:time	場所やサービスなどの開始時間を記述するためのプロパティ用語
関与	ic2:関与型	関連する組織や人（関連性の記述を含む）を記述するためのプロパティ用語
関与者	ic2:実体型	関連する組織や人を記述するためのプロパティ用語
関連イベント	ic2:イベント型	関連するイベントを記述するためのプロパティ用語
関連コード	ic2:コード型	当該コードに関連するコードを記述するためのプロパティ用語
関連人員	ic2:人数型	関連する人員の人数（従業員数など）を記述するためのプロパティ用語
関連施設	ic2:施設関連型	関連する施設（上位施設、下位施設など）を記述するためのプロパティ用語
関連組織	ic2:組織関連型	関連する組織を記述するためのプロパティ用語
電話番号	ic2:電話番号型	電話番号を記述するためのプロパティ用語　※0-9 の数字及び + - ( ) , の文字のみを使用
面積	ic2:面積型	土地などの面積を記述するためのプロパティ用語
駐車場	ic2:駐車場型	駐車場を記述するためのプロパティ用語
駐車場種別	xsd:string	駐車場の種別の表記を記述するためのプロパティ用語
高さ	ic2:長さ型	形状の高さを記述するためのプロパティ用語
